Abrasion Resistance : 耐磨性
Acceptable runner/cavity ratio : 可接受流道/型腔比
Additive : 添加剂
Adhesive Assembly : 胶粘剂大会
Aging : 老龄化
Air Burn : 烧焦
Alloy : 合金
Ambient Temperature : 环境温度
Amorphous : 无定形
Anisotropy : 各向异性
Annealing : 退火
ANSI : ANSI 美国标准化组织
Antioxidant : 抗氧化
Antiozonants : 抗臭氧剂
Antistatic Agent : 抗静电剂
Application : 应用程序
Ash Content : 灰分含量
Aspect Ratio : 长宽比
Assembly : 组装
A-stage : 树脂分子反应的早期阶段
ASTM : 美国缩写习惯，检验与材料
Back Pressure : 背压
Backflow : 回流
Backing Plate : 垫板
Balanced Runner : 一种保证所有注腔与注嘴距离相等的系统
Barrel : 桶
Binder : 粘结剂
Biocides & Fungicides : 杀菌剂和杀真菌剂
Black Specks : 由于材料热老化引起的黑斑
Blast Finishing : 高炉整理
Blister : 吸塑
Blocking & Anticaking Agents : 阻塞和抗结剂
Bloom (also know as Migration) : 在塑料表面出现的一中不理想的云状斑痕, 由于稳定着色剂、润滑剂、塑化剂溢出引起
Blow Molding : 吹塑
Blushing : 由于压力过大引起的塑料表面苍白
Boss : 为了增加压力与连接性等设计的磨具突起部分
Branching : 分支
Breakdown Voltage : 击穿电压
Brighteners : 增白剂
Brittle Temperature : 脆化温度
Broken Mold Marks : 模具表面缺陷造成部分损失。
B-stage : B阶
Bubbles : 泡沫
Bulk Density : 容重
Bulk Factor : 批量因子
Bulk-molding compounds (BMC) : 散装成型化合物（BMC）
Burned : 烧伤
Casting : 铸造
Cavity : 腔
Charge : 一个周期要注入的材料总量
Charpy Impact Test : 一种破破坏性的冲击试验
Clamp : 钳
Clamping Area : 夹紧区域
Clamping Force : 锁模力
Clamping Plate : 夹板
Clamping Pressure : 夹紧压力
Clarifiers : 澄清
Closed-loop Control : 闭环控制
Coefficient of Thermal Expansion (CTE) : 热膨胀系数（CTE）
Co-Injection : 共注射
Cold Flow Lines : 冷的流线
Cold Molding : 冷成型
Color Concentrate (also know as Colorant Pigment) : 色母料（也知道作为着色剂颜料）
Colorant (also know as Color Concentrate Pigment) : 着色剂（也称为色母料颜料）
Composite : 复合材料
Compound : 复合
Compounding : 将材料与所有添加剂混合
Compression Molding : 压缩成型
Compressive Strength : 抗压强度
Constant pressure gradient : 恒定的压力梯度
Continuous Service Temperature : 连续使用温度
Controlled frictional heating : 控制摩擦加热
Cooling Channels : 冷却通道
Cooling time : 冷却时间
Copolymer : 共聚物
Core : 核心
Corona Treatment : 电晕处理
Corrosion Resistance : 耐腐蚀
Corrosion Resistance : 耐腐蚀
Coupling Agents : 偶联剂
Crack/Splits/Chips : 破解/分割/芯片
Crazing : 龟裂
Creep : 蠕变
Cross-linking : 交联
Crystal : 水晶
Crystallinity : 结晶度
CSA : CSA
C-stage : C型阶段
Cure Cycle : 固化周期
Cure : 固化
Custom Molder : 自定义成型机
Cycle Time : 周期时间
Cycle : 周期
Damping : 阻尼
Deflection Temperature : 变形温度
Degassing : 脱气
Degradation : 降解
Delamination : 分层
Density : 密度
Design Review : 设计审查
Diaphragm Gate : 膜片门
Dielectric Strength : 介电强度
Differential Cooling : 差分冷却
Direct Gate : 直接门
Discoloration : 变色
Dispersion Aids : 分散助剂
Dominant Flow Path : 显性的流径
Draft : 草案
Drag Marks : 拖痕
Drooling : 流口水
Drying : 干燥
Durometer : 硬度计
Dwell : 停留时间
Edge gate : 边缘浇口
Ejection Pin Marks : 弹射引脚商标
Ejection Pin : 弹射引脚
Ejector Return Pins : 顶针返回销
Ejector Rod : 顶杆
Elastic Memory : 弹性记忆
Elasticity : 弹性
Elastomer : 弹性体
Element : 元
Elongation Break : 断裂伸长率断裂
Engineering Plastics : 工程塑料
Extender : 扩展
Extrudate : 挤出
Extrusion : 挤压
Fabricating : 制作
Family mold : 家庭模具
Fan Gate : 扇形浇口
Fatigue Strength : 疲劳强度
Fill pattern : 材料逐步填充，冷却后形成的填充过程图案
Fill pressure : 补压
Fill Time (also known as Injection) : 填充时间（又称注射）
Fill : 填充
Filler : 灌装机
Fines : 罚款
Finish : 完成
Finite element analysis : 有限元分析
Flame Retardant : 阻燃
Flash Gate : 闪光门
Flash : 闪光
Flexural Strength Yield : 弯曲强度屈服
Flexural Strength : 弯曲强度
Flow Balancing : 流量平衡
Flow Leader : 流程负责人
Flow Marks : 流痕
Flow Pattern : 流态
Flow Rate : 流量
Foaming Agent : 发泡剂
Fracture : 组件的碎裂，由于材料的易碎或可延展性引起
Freeze off : 冻结了
Frictional heating : 摩擦热
Gate Blush : 在注嘴部分的瑕疵
Gate Trim : 切断注嘴与注件留下的斑点
Gate : 热流道与注腔间的阀门
Glass Fibers : 玻璃纤维
Glass transition : 玻璃化转变
Hardener : 固化剂
Hardness : 硬度
Haze : 注件的轻微浑浊现象
Heat Stabilizers : 热稳定剂
Homopolymer : 均聚物
Hopper Dryers : 料斗干燥器
Hopper Loader : 料斗装载机
Hot-Runner Mold (also known as Insulated Runner or Runnerless Molding) : 热流道模具（又称绝缘亚军或流道成型）
Hygroscopic : 吸湿性
Impact Modifiers : 冲击改性剂
Impact Resistance : 耐冲击性
Impact Strength : 冲击强度
Injection (also known as Fill Time) : 注射液（又称填充时间）
Injection Blow Molding : 注吹中空成型
Injection Molding Pressure : 注塑压力
Injection Molding : 注塑成型
Injection Pressure : 注射压力
Insert Molding : 嵌件成型
Insert : 插入
Insulated Runner (also known as Hot-Runner Mold or Runnerless Molding) : 绝缘亚军（又称热流道模具或流道成型）
Isobar : 一条等压线
Isochrone : 等时
Isotherm : 等温线
Izod Impact Test : 一种拉伸测试
Izod Notched LT : 在-40°的时候进行的端口测试
Izod Notched RT : 切断测试样本需要的能量
Jetting : 喷射
Jig : 用于在组装时固定器件一端的工具
K-Factor : K系数
Knit Lines : 针织线
Knockout Pin : 顶杆
Land (Gate Area) : 阀门液体流动的平行方向
Land Area : 模具闭合的时候接触的地方
Light UV Stabilizers & Absorbers : 灯紫外线稳定剂和吸收剂
Linear Mold Shrinkage : 线性成型收缩率
Linear Thermal Expansion : 线性热膨胀
Liquid Injection Molding (LIM) : 液体注射成型（LIM）的
Low Temperature Flexibility : 低温弹性
Lubricant : 润滑剂
Machine Shot Capacity : 机拍摄能力
Mar Resistance : 抗擦伤性
Masterbatch : 色母粒
Material Safety Data Sheets : 材料安全数据表
Melt Flow Rate : 熔体流动速率
Melt Flow : 熔体流动
Melt Index : 熔融指数
Melt Strength : 熔体强度
Memory : 记忆体
Metallizing : 镀膜
Migration (also know as Bloom) : 在塑料表面出现的一中不理想的云状斑痕, 由于稳定着色剂、润滑剂、塑化剂溢出引起
Mineral Reinforcements : 矿产增援
Minimum Specifications : 最低规格
Modulus in Compression : 压缩模量
Modulus in Flexure : 弹性模量在弯曲
Modulus in Shear : 模剪切
Modulus of Elasticity : 弹性模量
Modulus of Resilience : 弹性模数
Modulus : 弹性模量
Moisture Absorption : 吸收水分
Mold (n) : 模具（N）
Mold (v) : 模具（V）
Mold Frame : 模架
Mold Release Problems : 脱模剂的问题
Mold Release : 脱模
Mold Temperature : 模具温度
Moldability : 可塑性
Molding Cycle : 成型周期
Molding Pressure : 成型压力
Molding sensitivity : 成型的敏感性
Molding window : 成型窗口
Mold-Temperature-Control Unit : 模具温度控制单元
Molecular Weight : 分子量
Molecule : 分子
Monomer : 单体
Moving Platen : 动模板
Multi-Cavity Mold : 多腔模具
Multidirectional flow : 多向流动
Multiple cavity mold : 多型腔模具
Multi-Shot Molding : 多射成型
co-injection)  Naturally balanced runner system : 合作注入）自然平衡的热流道系统
Nest Plate : 巢板
Non-Fill (also known as Short Shot) : 非填充（又称短射）
Non-Return Valve : 非回流阀
Notch Sensitivity : 缺口敏感性
Nozzle  : 喷嘴
Nucleating Agent : 核剂
Odorants & Deodorants : 气味和除臭剂
Opaque : 不透明
Orange Peel : 橘皮
Orientation : 方向
Orifice : 孔板
Over Molding : 在成型
Overpack : 外包装
Oxygen Index : 氧指数
Packing : 包装
Part Picker : 部分选择器
Partially-balanced runner system : 部分平衡的热流道系统
Parting line : 分模线
Peeling : 脱皮
Photodegradation : 光降解
Pigment (also know as Colorant Color Concentrate) : 颜料（也知道作为着色剂色母料）
Pinpoint Gate : 找准门
Piston : 活塞
Pit : 坑
Plastic Deformation : 塑性变形
Plastic : 塑料
Plasticity : 可塑性强
Plasticize : 塑化
Plasticizer : 增塑剂
Platens : 用于安装即支撑磨具的压板
Plate-Out : 板输出
Plots : 图标表达的分析结果
Poisson's Ratio : 泊松比
Polymer Structure : 聚合物结构
Polymer : 聚合物
represented by a repeated small unit the mer : 代表一个反复的小单位MER
Polymerization : 聚合
Pressure Pads : 压力垫
Processing Aids : 加工助剂
Proportional Limit : 比例限制
Prototype Tool : 原型工具
Pulled Gate : 拉闸门
Purging : 清除
Raised Ejector Site : 募集顶针网站
Ram : 拉姆
Reaction Injection Molding (RIM) : 反应注射成型（RIM）
Reagent Resistance : 试剂电阻
Recovery Time : 恢复时间
Regrind : 回用料
Reinforced Plastic : 增强塑料
Release agent : 脱模剂
Resin (Synthetic) : 树脂（合成）
Restricted Gate : 限制门
Retainer Plate : 固定板
Retractable Cores : 可伸缩内核
Rib : 模具的增强筋
Robot : 机器人
Rockwell Hardness : 洛氏硬度计
Runner Balancing : 一种根据注腔的数量来给压给料的系统
Runner Design : 热流道设计
Runner System : 热流道系统
Runner : 热流道
Runnerless molding (also known as Hot-Runner Mold or Insulated Runner) : 热流道成型（又称热流道模具或绝缘热流道）
Scrap : 废钢
Screw Travel : 螺杆行程
Shear rate : 剪切速率
Shear Strength : 剪切强度
Shear stress : 剪应力
Short Shot (also known as Non-Fill) : 短射（也称为非填充）
Shot Capacity : 注射容量
Shot : 注塑机一次完整的周期
Shrinkage Allowance : 收缩津贴
Side-Draw Pins : 侧注嘴，关闭模具要抽出的
Sink Mark : 缩痕，腔壁位置的缩痕，在过厚的部分容易出现
Skin : 材料表面的致密层
Slide : 在腔内的注塑器，需要在关闭模具前抽出
Slip Agent : 滑剂
Solvents : 溶剂
Specific Gravity : 比重
Specific Volume : 具体数量
Spiral Flow : 螺旋流
Splay Marks : 注件表面由于材料溶解过快导致的缺失或伤痕
Split-Ring Mold : 开环模
Sprue Bushing : 浇口衬套
Sprue Gate : 浇口门
Sprue Lock : 浇口锁
Sprue : 浇口
Stabilizer : 稳定
Stack Molds : 叠层模具
Stationary Platen : 固定压板
Stiffness : 刚度
Stress Concentrators : 应力集中
Stress Cracking : 应力开裂
of these types of stress cracking have the same end result : 应力开裂的这些类型具有相同的最终结果
Stress Relaxation : 应力松弛
Stress : 应力
Stress-Crack : 应力开裂
Stress-Strain Curve : 应力 - 应变曲线
Striations : 条纹
Strings : 由于注嘴阀门关断导致的材料拉丝
Stripper Plate : 卸料板
Structural Foam Molding : 结构发泡成型
Subgate : 子阀门
Suck-back : 回吸
Tab Gate : 注件在阀门口凝固的小得材料块
Tackifiers : 增粘剂
Tensile Modulus : 拉伸模量
Tensile Strength Break : 拉伸强度断裂
Tensile Strength Yield : 抗拉强度屈服
Thermal Conductivity : 热导率
Thermal Degradation : 热降解
Thermal Shut-Off : 热关机
Thermoelasticity : 热弹性
Thermoforming : 热成型
Thermoplastic Elastomers : 热塑性弹性体
Thermoplastic : 热塑性塑料
Thermoset : 热固性
Tie-Bar Spacing : 拉杆间距
Time scan : 扫描时
Toggle : 切换
Tonnage : 吨位
Tool : 工具
Transfer Molding : 传递模塑
Transition Temperature : 转变温度
Tunnel Gate : 隧道门
UL Temperature Index : UL温度指数
Ultimate Elongation : 断裂伸长率
Ultimate Strength : 最终强度。
Underflow : 下溢
Unidirectional Flow Pattern : 单向流动模式
Uniform Cooling Time : 均匀冷却时间
Vacuum Forming : 真空成型
Valve Gating : 阀选通
Vent : 发泄
Vented Barrel : 通风桶
Vertical Flash Ring : 垂直闪光环
Vicat Softening Point : 维卡软化点
Virgin Material : 原始材料
Viscoelasticity : 粘弹性
Viscosity : 粘度
Void : 未被填充的模具部分，由于材料在腔内未融化
Warpage : 翘曲
Water Absorption : 吸水率
Weld Line : 焊接线
Wisps : 一种很细的材料拉丝导致的火光
Yellowness Index : 黄色指数
Yield Point: 拉力测试，应力变形曲线的第一个弯曲点
Yield Strength : 屈服强度
Young's Modulus : 杨氏模量
