Visual studio 2008 valuable shortcuts;Note=Erxin

:Build
>Build.BuildSolution	Global::Ctrl+Shift+B --OR-- Global::F7
>Build.Compile	Global::Ctrl+F7

:Debug
>Debug.Breakpoints	Global::Ctrl+Alt+B --OR-- Global::Alt+F9
>Debug.DeleteAllBreakpoints	Global::Ctrl+Shift+F9
>Debug.Immediate	Global::Ctrl+Alt+I
>Debug.Processes	Global::Ctrl+Alt+Z --OR-- Global::Ctrl+Shift+Alt+P
>Debug.QuickWatch	Global::Ctrl+Alt+Q --OR-- Global::Shift+F9
>Debug.Registers	Global::Ctrl+Alt+G --OR-- Global::Alt+5
>Debug.RunToCursor	Global::Ctrl+F10
>Debug.StartWithoutDebugging	Global::Ctrl+F5
>Debug.StepIntoCurrentProcess	Global::Ctrl+Alt+F11
>Debug.StepIntoSpecific	Global::Shift+Alt+F11
>Debug.Threads	Global::Ctrl+Alt+H

:Edit
>Edit.FormatDocument	Text Editor::Ctrl+K, Ctrl+D
>Edit.FormatSelection	Text Editor::Ctrl+K, Ctrl+F --OR-- Global::Alt+F8
>Edit.GoTo	Global::Ctrl+G
>Edit.GotoBraceExtend	Text Editor::Ctrl+Shift+]
>Edit.GoToDeclaration	Global::Ctrl+F12 --OR-- Global::Ctrl+Alt+F12
>Edit.GoToFindCombo	Global::Ctrl+D
>Edit.GoToReference	Global::Shift+F12
>Edit.HideSelection	Text Editor::Ctrl+M, Ctrl+H
>Edit.IncrementalSearch	Text Editor::Ctrl+I
>Edit.InsertSnippet	Global::Ctrl+K, Ctrl+X
>Edit.LineCut	Text Editor::Ctrl+L --OR-- Global::Shift+Alt+L
>Edit.LineTranspose	Text Editor::Shift+Alt+T
>Edit.ListMembers	Text Editor::Ctrl+J --OR-- Global::Ctrl+Alt+T
>Edit.QuickFindSymbol	Global::Shift+Alt+F12
>Edit.QuickInfo	Text Editor::Ctrl+K, Ctrl+I
>Edit.SelectCurrentWord	Text Editor::Ctrl+W
>Edit.SelectToLastGoBack	Text Editor::Ctrl+=
>Edit.StopHidingCurrent	Text Editor::Ctrl+M, Ctrl+U
>Edit.SurroundWith	Global::Ctrl+K, Ctrl+S
>Edit.ToggleBookmark	Text Editor::Ctrl+K, Ctrl+K --OR-- Global::Ctrl+F2
>Edit.UpdateJScriptIntellisense	HTML Editor Source View::Ctrl+Shift+J
>Edit.WordNextExtendColumn	Text Editor::Ctrl+Shift+Alt+Right Arrow
>Edit.WordTranspose	Text Editor::Ctrl+Shift+T

:Help
>Help.HowDoI	Global::Ctrl+F1

:Refactor
>Refactor.EncapsulateField	Global::Ctrl+R, Ctrl+E
>Refactor.ExtractInterface	Global::Ctrl+R, Ctrl+I
>Refactor.ExtractMethod	Global::Ctrl+R, Ctrl+M

:Test
>Test.DebugTestsInClass	Global::Ctrl+R, Ctrl+C
>Test.DebugTestsInCurrentContext	Global::Ctrl+R, Ctrl+T
>Test.DebugTestsInNamespace	Global::Ctrl+R, Ctrl+N
>Test.RunAllTestsInSolution	Global::Ctrl+R, A

:Toolbox
>Tools.AttachtoProcess	Global::Ctrl+Alt+P
>Tools.CodeSnippetsManager	Global::Ctrl+K, Ctrl+B
>Tools.GoToCommandLine	Global::Ctrl+/
>Tools.MacrosIDE	Global::Alt+F11

:View
>View.Backward	Global::Alt+Left Arrow
>View.BookmarkWindow	Global::Ctrl+K, Ctrl+W
>View.ClassView	Global::Ctrl+Shift+C
>View.FullScreen	Global::Shift+Alt+Enter
>View.NavigateBackward	Global::Ctrl+-
>View.NavigateForward	Global::Ctrl+Shift+-
>View.NextError	Global::Ctrl+Shift+F12
>View.ObjectBrowser	Global::Ctrl+Alt+J
>View.Output	Global::Ctrl+Alt+O --OR-- Global::Alt+2
>View.PropertiesWindow	Global::Alt+Enter
>View.TaskList	Global::Ctrl+\, Ctrl+T --OR-- Global::Ctrl+\, T
>View.Toolbox	Global::Ctrl+Alt+X
>View.WebBrowser	Global::Ctrl+Alt+R

:Window
>Window.MovetoNavigationBar	Global::Ctrl+F8
>Window.NextDocumentWindow	Global::Ctrl+F6
>Window.NextDocumentWindowNav	Global::Ctrl+Tab
>Window.NextPane	Global::Alt+F6
>Window.PreviousDocumentWindow	Global::Ctrl+Shift+F6
>Window.ShowEzMDIFileList	Global::Ctrl+Alt+Down Arrow

:Display the hinted reference window
ctrl+ .